----------
-XXXXXXXXS
-XXXXXXXX-
-XXXXXXXX-
-XXXXXXXX-
GXXXXXXXX-
-XXXXXXXX-
-XXXXXXXX-
-XXXXXXXX-
----------