----------
----------
----------
----------
-S---X-X-X
----------
X---GX-X-X
----------
----------
----------