G---------
XXXXXXXXX-
--------X-
-XXXXXX-X-
-X----X-X-
-X-XXSX-X-
-X-XXXX-X-
-X------X-
-XXXXXXXX-
----------